40
25
11 11 11 11 11 11 11 11 11 21 22 21 22 21 22 21 
22 21 22 21 22 21 22 21 22 11 11 11 11 11 11 11 
11 11 11 11 11 11 11 11
11 5 5 5 5 5 5 5 11 12 13 12 13 12 13 12 
13 12 13 12 13 12 13 12 13 16 17 3 3 3 3 3 
3 3 3 3 3 3 3 16
11 3 3 3 3 3 3 3 11 21 22 21 22 21 22 21 
22 21 22 21 22 21 22 21 22 25 26 3 3 3 3 3 
3 11 3 3 3 11 3 25
11 3 3 3 3 3 10 3 11 12 13 12 13 12 13 12 
13 12 13 12 13 12 13 12 13 16 17 3 3 3 3 3 
3 3 3 3 3 3 3 16
11 3 3 3 3 3 10 10 11 21 22 21 22 21 22 21 
22 21 22 21 22 21 22 21 22 25 26 11 3 3 3 3 
3 3 3 3 3 3 3 25
11 10 3 3 3 10 10 10 11 12 13 12 13 12 13 12 
13 12 13 12 13 12 13 12 13 16 17 11 11 3 3 11 
3 3 3 3 3 3 11 16
11 10 10 3 3 10 10 10 11 21 22 21 22 21 22 21 
22 21 22 21 22 21 22 21 22 25 26 3 3 3 3 3 
3 3 3 11 3 3 3 25
11 10 10 3 3 10 10 10 11 12 13 12 13 12 13 12 
13 12 13 12 13 12 13 12 13 16 17 3 3 3 3 3 
3 3 3 3 3 3 3 16
17 16 17 3 3 16 17 16 17 21 22 21 22 21 22 21 
22 21 22 21 22 21 22 21 22 25 26 3 3 3 3 11 
11 3 3 3 3 3 3 25
26 25 26 3 3 25 26 25 26 12 13 12 13 12 13 12 
13 12 13 12 13 12 13 12 13 16 17 3 3 3 3 3 
3 3 3 3 3 3 3 16
16 17 3 3 3 3 16 17 11 21 22 21 22 21 22 21 
22 21 22 21 22 21 22 21 22 25 26 11 11 11 3 3 
3 3 3 3 3 3 3 25
25 26 3 0 0 3 25 26 11 12 13 12 13 12 13 12 
13 12 13 12 13 12 13 12 13 16 17 3 3 3 3 3 
3 3 3 3 3 3 3 16
17 3 3 0 0 3 3 16 17 21 22 21 22 21 22 21 
22 21 22 21 22 21 22 21 22 25 26 3 3 3 3 11 
11 11 3 3 3 3 3 25
26 3 0 0 0 0 3 25 26 12 13 12 13 12 13 12 
13 12 13 12 13 12 13 12 13 16 17 16 17 16 17 16 
17 16 17 0 0 0 16 17
11 0 0 0 0 0 0 3 11 21 22 21 22 21 22 21 
22 21 22 21 22 21 22 21 22 25 26 25 26 25 26 25 
26 25 26 0 0 0 25 26
11 0 0 0 0 0 0 0 0 1 2 1 2 1 2 1 
2 1 2 1 2 1 2 1 2 5 5 5 5 5 5 5 
5 0 0 0 16 17 16 17
11 4 4 4 4 4 4 4 4 4 4 4 4 4 4 4 
4 4 4 4 4 4 4 4 4 4 4 4 4 4 4 4 
4 4 4 4 25 26 25 26
11 4 4 4 4 4 4 4 4 4 4 4 4 4 4 4 
4 4 4 4 4 4 4 4 4 4 4 4 4 4 4 4 
4 4 16 17 16 17 16 17
11 4 4 4 4 4 4 4 4 4 4 4 4 4 4 4 
4 4 4 4 4 4 4 4 4 4 4 4 4 4 4 4 
4 4 25 26 25 26 25 26
11 4 4 4 4 4 4 4 4 4 4 4 4 4 4 4 
4 4 4 4 4 4 4 4 4 4 4 4 4 4 4 4 
16 17 16 17 16 17 16 17
11 4 4 4 4 4 4 4 4 4 4 4 4 4 4 4 
4 4 4 4 4 4 4 4 4 4 4 4 4 4 4 4 
25 26 25 26 25 26 25 26
11 4 4 4 11 11 4 4 4 4 4 4 4 4 4 4 
4 4 4 11 11 11 11 11 11 4 4 4 4 4 16 17 
16 17 16 17 16 17 16 17
11 4 4 11 11 11 11 4 4 4 4 4 4 4 4 4 
4 4 11 11 10 10 10 10 11 11 4 4 4 4 25 26 
25 26 25 26 25 26 25 26
14 15 14 15 14 15 14 14 15 14 15 14 15 14 15 14 
15 14 15 14 15 14 15 14 15 14 15 14 15 14 15 14 
15 14 15 14 15 14 15 14
23 24 23 24 23 24 23 23 24 23 24 23 24 23 24 23 
24 23 24 23 24 23 24 23 24 23 24 23 24 23 24 23 
24 23 24 23 24 23 24 23